3
0333333333330
0333333333330
0300333330030
0300333330030
0333300033330
0333300033330
0330000000330
0330333330330
13x8
