6
0666666666660
0666666666660
0600006000060
0666666666660
0676666666760
0667666667660
0666600066660
0666666666660
13x8
