30
0000011100000000000001100002222
0000111110000000000011110000222
0000011100000000000111111000022
1000000000001110000001111000002
0111000000111111110000011100000
1111100001111111111000000000000
0111000000111111110000000011110
0000000000001111000000001111110
0000111000000000000000011111111
0011111110000000000111000011110
0111111111000000011111110000111
0000111111100000111111111000000
0000001110000000011111110000000
0000000000000000000111000000000
0000000000000000000000000000000
31x15

