5
1234567800000000000000000000000
0000000000000011222111000000000
0000000000000111222111000000000
0000000000001112222111000000000
1111111000011112222111111111111
1222222000011112222111111111111
1222222111111112222111111111111
1222222111111113333111111111111
1333333111111113333111111111111
1333333111111113333111111111111
1333333111111113333111111111111
1333333111111113333111111111111
31x12
