1
0011166666100
0011166661100
0000166610000
0000166110000
0011111111100
0011666661100
0016000006100
0016000006100
13x8

