4
0333344444430
0334344444340
0344444444440
0444444444440
0440044400440
0444400044440
0440000000440
0444444444440
13x8
