7
0777777777770
0777777777770
0755577755570
0755557555570
0777777777770
0777777777770
0777555557770
0777777777770
13x8

